11111111111111111111111
1P00000000C000000000001
11111111111111111111101
1000000000C000000000001
10111111111111111111111
1000000000C0000000000E1
11111111111111111111111