1111111111
1P00000001
1010010101
100C001001
1000000001
1C11C11C11
1000000001
1111111101
1E00000001
1111111111