11111111111111
10010000000C01
1000011111001
1P0011E0000011
11111111111111